..##.........##.........##.........##.........##.........##.........##.........##.........##.........##.........##.........##.........##.........##.........##.........##.........##.........##.........##.........##.........##.........##.........##.........##.........##.........##.........##.........##.........##.........##.........##.........##.........##.........##.........##.........##.......
#...#...#..#...#...#..#...#...#..#...#...#..#...#...#..#...#...#..#...#...#..#...#...#..#...#...#..#...#...#..#...#...#..#...#...#..#...#...#..#...#...#..#...#...#..#...#...#..#...#...#..#...#...#..#...#...#..#...#...#..#...#...#..#...#...#..#...#...#..#...#...#..#...#...#..#...#...#..#...#...#..#...#...#..#...#...#..#...#...#..#...#...#..#...#...#..#...#...#..#...#...#..#...#...#..#...#...#..
.#....#..#..#....#..#..#....#..#..#....#..#..#....#..#..#....#..#..#....#..#..#....#..#..#....#..#..#....#..#..#....#..#..#....#..#..#....#..#..#....#..#..#....#..#..#....#..#..#....#..#..#....#..#..#....#..#..#....#..#..#....#..#..#....#..#..#....#..#..#....#..#..#....#..#..#....#..#..#....#..#..#....#..#..#....#..#..#....#..#..#....#..#..#....#..#..#....#..#..#....#..#..#....#..#..#....#..#.
..#.#...#.#..#.#...#.#..#.#...#.#..#.#...#.#..#.#...#.#..#.#...#.#..#.#...#.#..#.#...#.#..#.#...#.#..#.#...#.#..#.#...#.#..#.#...#.#..#.#...#.#..#.#...#.#..#.#...#.#..#.#...#.#..#.#...#.#..#.#...#.#..#.#...#.#..#.#...#.#..#.#...#.#..#.#...#.#..#.#...#.#..#.#...#.#..#.#...#.#..#.#...#.#..#.#...#.#..#.#...#.#..#.#...#.#..#.#...#.#..#.#...#.#..#.#...#.#..#.#...#.#..#.#...#.#..#.#...#.#..#.#...#.#
.#...##..#..#...##..#..#...##..#..#...##..#..#...##..#..#...##..#..#...##..#..#...##..#..#...##..#..#...##..#..#...##..#..#...##..#..#...##..#..#...##..#..#...##..#..#...##..#..#...##..#..#...##..#..#...##..#..#...##..#..#...##..#..#...##..#..#...##..#..#...##..#..#...##..#..#...##..#..#...##..#..#...##..#..#...##..#..#...##..#..#...##..#..#...##..#..#...##..#..#...##..#..#...##..#..#...##..#.
..#.##.......#.##.......#.##.......#.##.......#.##.......#.##.......#.##.......#.##.......#.##.......#.##.......#.##.......#.##.......#.##.......#.##.......#.##.......#.##.......#.##.......#.##.......#.##.......#.##.......#.##.......#.##.......#.##.......#.##.......#.##.......#.##.......#.##.......#.##.......#.##.......#.##.......#.##.......#.##.......#.##.......#.##.......#.##.......#.##.....
.#.#.#....#.#.#.#....#.#.#.#....#.#.#.#....#.#.#.#....#.#.#.#....#.#.#.#....#.#.#.#....#.#.#.#....#.#.#.#....#.#.#.#....#.#.#.#....#.#.#.#....#.#.#.#....#.#.#.#....#.#.#.#....#.#.#.#....#.#.#.#....#.#.#.#....#.#.#.#....#.#.#.#....#.#.#.#....#.#.#.#....#.#.#.#....#.#.#.#....#.#.#.#....#.#.#.#....#.#.#.#....#.#.#.#....#.#.#.#....#.#.#.#....#.#.#.#....#.#.#.#....#.#.#.#....#.#.#.#....#.#.#.#....#
.#........#.#........#.#........#.#........#.#........#.#........#.#........#.#........#.#........#.#........#.#........#.#........#.#........#.#........#.#........#.#........#.#........#.#........#.#........#.#........#.#........#.#........#.#........#.#........#.#........#.#........#.#........#.#........#.#........#.#........#.#........#.#........#.#........#.#........#.#........#.#........#
#.##...#...#.##...#...#.##...#...#.##...#...#.##...#...#.##...#...#.##...#...#.##...#...#.##...#...#.##...#...#.##...#...#.##...#...#.##...#...#.##...#...#.##...#...#.##...#...#.##...#...#.##...#...#.##...#...#.##...#...#.##...#...#.##...#...#.##...#...#.##...#...#.##...#...#.##...#...#.##...#...#.##...#...#.##...#...#.##...#...#.##...#...#.##...#...#.##...#...#.##...#...#.##...#...#.##...#...
#...##....##...##....##...##....##...##....##...##....##...##....##...##....##...##....##...##....##...##....##...##....##...##....##...##....##...##....##...##....##...##....##...##....##...##....##...##....##...##....##...##....##...##....##...##....##...##....##...##....##...##....##...##....##...##....##...##....##...##....##...##....##...##....##...##....##...##....##...##....##...##....#
.#..#...#.#.#..#...#.#.#..#...#.#.#..#...#.#.#..#...#.#.#..#...#.#.#..#...#.#.#..#...#.#.#..#...#.#.#..#...#.#.#..#...#.#.#..#...#.#.#..#...#.#.#..#...#.#.#..#...#.#.#..#...#.#.#..#...#.#.#..#...#.#.#..#...#.#.#..#...#.#.#..#...#.#.#..#...#.#.#..#...#.#.#..#...#.#.#..#...#.#.#..#...#.#.#..#...#.#.#..#...#.#.#..#...#.#.#..#...#.#.#..#...#.#.#..#...#.#.#..#...#.#.#..#...#.#.#..#...#.#.#..#...#.# 